RX  F   2
0   F   2
TX  F   8
1   F   8
2   E   8
3   D   0
4   C   14
5   D   1
6   D   2
7   E   9
8   D   12
9   D   3
10  D   4
11  C   4
12  A   2
LED A   3
13  A   3
14  F   13
15  F   12
16  F   5
17  F   4
18  D   15
19  D   14
20  A   15
21  A   14
22  C   2
23  C   3
24  C   0
25  F   3
26  G   3
27  G   2
28  G   15
29  G   7
30  E   7
31  E   6
32  E   5
33  E   4
34  E   3
35  E   2
36  E   1
37  E   0
38  D   10
39  D   5
40  B   11
41  B   13
42  B   12
43  G   8
44  A   10
45  F   0
46  F   1
47  D   6
48  D   8
49  D   11
50  G   7
51  G   8
52  G   6
53  G   9
A0  B   0
54  B   0
A1  B   1
55  B   1
A2  B   2
56  B   2
A3  B   3
57  B   3
A4  B   4
58  B   4
A5  B   5
59  B   5
A6  B   6
60  B   6
A7  B   7
61  B   7
A8  B   8
62  B   8
A9  B   9
63  B   9
A10 B   10
64  B   10
A11 B   11
65  B   11
A12 B   12
66  B   12
A13 B   13
67  B   13
A14 B   14
68  B   14
A15 B   15
69  B   15
70  A   0
71  A   1
72  A   4
73  A   5
74  D   9
75  C   13
76  D   13
77  D   7
78  G   1
79  G   0
80  A   6
81  A   7
82  G   14
83  G   12
84  G   13
85  A   9
